aamp (approval and authorization management process) - 승인 및 인가 관리 절차
aamp process - aamp 절차
accelerated death benefit - 가속 사망 혜택
accidental death and dismemberment - 사고 사망 및 신체 절단
accidental events - 사고 사건
accountability - 책임
accounts booking - 회계 처리
accuracy - 정확성
actions - 조치
active role - 적극적 역할
actuarial department - 보험계리부
actuarial projections - 계리 예상
actuarial roles - 계리 역할
actuarial teams - 계리팀
actuary - 계리사
addition - 추가
adequacy - 적절성
adequate protection - 적절한 보호
adherence - 준수
administration - 관리
administrative changes - 행정 변경
administrative matters - 행정 사항
adverse circumstances - 불리한 상황
advisors - 자문사
aggregation of risks - 위험 집계
agreed template - 합의된 템플릿
aia company limited - aia 회사 리미티드
aia governance - aia 거버넌스
aia group - aia 그룹
aia group governance - aia 그룹 거버넌스
aia group policies or standards - aia 그룹 정책 또는 표준
aia group reinsurance management policy - aia 그룹 재보험 관리 정책
aia group rmp - aia 그룹 재보험 관리 정책
aia group’s reinsurance policies - aia 그룹의 재보험 정책
aia group’s risk appetite - aia 그룹의 위험 선호
aia international limited - aia 인터내셔널 리미티드
aia korea bod - aia korea 이사회
aia korea cfo - aia korea 최고재무책임자
aia korea chief actuary - aia korea 최고 계리사
aia korea executives - aia korea 경영진
aia korea frc - aia korea 재무 및 위험 위원회
aia korea rmp - aia korea 재보험 관리 정책
alternative risk transfer arrangements - 대체 위험 이전 계약
amendments - 수정
annual review process - 연례 검토 과정
annual strategic planning process - 연간 전략 계획 과정
anomalies - 이상 현상
anticipated value - 예상 가치
appendix - 부록
appetite for risks - 위험 선호도
applicable law - 적용 가능한 법률
applicable regulation - 적용 가능한 규정
application - 적용
approval - 승인
approved arrangement - 승인된 계약
approved reinsurance retention limits - 승인된 재보험 유지 한도
arm's length terms - 공정 거래 조건
arrangement with insignificant risk transfer - 무의미한 위험 이전 계약
arrangements - 계약
arrangements with insignificant risk transfer - 무의미한 위험 이전 계약
art (alternative risk transfer) - 대체 위험 이전
assessment - 평가
assets - 자산
attachments - 첨부 파일
audit coverage - 감사 범위
audit examination - 감사 검토
authorised - 승인된
authorised limit - 승인 한도
authority limit - 권한 한도
authorized limit - 승인된 한도
availability - 가능성
background - 배경
bankruptcy remoteness - 파산 원격성
basis risk - 기준 위험
benefits - 혜택
binding offer - 구속적 제안
board - 이사회
board audit committee - 이사회 감사 위원회
board of director - 이사회
body - 본문
breach - 위반
breach management - 위반 관리
breaches - 위반
broker - 중개인
broker’s experience - 중개인의 경험
bu (business unit) - 사업부
bu levels - 사업부 수준
business - 사업
business objectives - 사업 목표
business practice - 사업 관행
business purposes - 사업 목적
business terms - 사업 조건
capital - 자본
capital efficient manner - 자본 효율적 방식
capital management - 자본 관리
capital market - 자본 시장
capital position - 자본 위치
capitalization - 자본화
cash - 현금
cash generation - 현금 생성
catastrophe claim limits - 재난 청구 한도
catastrophe covers - 재난 커버
catastrophe reinsurance - 재해 재보험
catastrophe reinsurance program - 재해 재보험 프로그램
catastrophe risks - 재난 위험
catastrophic reinsurance placement - 재난 재보험 배치
catastrophic risk - 대재난 위험
ceding bu - 양도 사업부
ceding company - 양도 회사
cfo - 최고재무책임자
chief actuary - 최고 계리사
city - 도시
claim-related volatility - 청구 관련 변동성
claims - 청구
claims department - 청구부서
clearances - 클리어런스
co-developing product - 공동 개발 제품
collateral - 담보
collateral requirements - 담보 요구 사항
communication - 의사소통
competitive - 경쟁력 있는
compliance - 준수
comprehensive evaluation - 종합 평가
compulsory cession - 의무 양도
compulsory domestic cession - 의무적 국내 양도
confidentiality agreement - 기밀 유지 협약
conflict - 충돌
conflicts of interest - 이해 충돌
connected or related party transactions - 관련 당사자 거래
contingency liquidity sources - 비상 유동성 출처
contractual obligations - 계약 의무
contractual provisions - 계약 조항
control - 관리
convenience - 편의
conventional terrorism - 일반 테러리즘
corporate policy portal - 기업 정책 포털
corporate solutions business - 기업 솔루션 사업
cost effective - 비용 효율적인
counterparty - 상대방
country risk - 국가 위험
coverage - 보장
covered events - 보장된 사건
cpg standard - cpg 표준
credential of major reinsurers - 주요 재보험사의 자격
credit events - 신용 이벤트
credit limit approval - 신용 한도 승인
credit rating - 신용 등급
credit rating downgrade - 신용 등급 하락
credit requirements - 신용 요구 사항
credit risk - 신용 위험
credit risk exposure - 신용 위험 노출
creditworthiness - 신용도
critical illness - 중대 질병
cro - 최고위험책임자들
cross-border nature - 국경 간 특성
cross-border reinsurance - 국경 간 재보험
cross-border reinsurers - 국경 간 재보험사
cross-border risks - 국경 간 위험
customers - 고객
daily liquidity adequacy ratio (lar) - 일일 유동성 적정성 비율
data - 데이터
data errors - 데이터 오류
data quality - 데이터 품질
data shared - 공유된 데이터
date of birth - 생년월일
death - 사망
defined business purpose - 정의된 사업 목적
definitions - 정의
delayed recoveries - 지연된 회수
delegate - 위임받은 사람
delegation of authority - 권한 위임
delegation of roles - 역할 위임
deletion - 삭제
direct reports - 직속 보고자
disclosure - 공개
disclosure of sensitive data - 민감한 데이터 공개
discretion - 재량
dismantling arrangement - 해체 계약
disposal - 처분
dispute - 분쟁
distributable cash - 분배 가능 현금
diversification - 다양화
document - 문서
document details section - 문서 세부 정보 섹션
documentation - 문서화
documents - 문서
domestic reinsurers - 국내 재보험사
earnings - 수익
earnings volatility - 수익 변동성
earthquake - 지진
economic capital requirements - 경제 자본 요구 사항
economic conditions - 경제 조건
economically justifiable cost - 경제적으로 정당화된 비용
eligible counterparties - 적격 상대방
empowerment - 권한 부여
endorsement - 승인
enterprise risk management - 기업 위험 관리
erm - erm
escalation - 보고
evaluation - 평가
event or circumstance - 사건 또는 상황
excess risk - 초과 위험
executive committee - 집행위원회
executive management - 경영진
exemptions - 면제
existing policies - 기존 정책
existing reinsurance arrangements - 기존 재보험 계약
existing reinsurer - 기존 재보험사
experience - 경험
expertise - 전문 지식
exposure - 노출
exposure data - 노출 데이터
external agencies - 외부 기관
external cash flows - 외부 현금 흐름
external reinsurance - 외부 재보험
external risk - 외부 위험
facultative reinsurance - 임의 재보험
favorable terms - 유리한 조건
fcsa - 재무 통제 자체 관리
finance accounting team - 재무 회계 팀
financial - 재무
financial circumstances - 재정 상황
financial controller - 재무 관리자
financial guarantors - 금융 보증인
financial position - 재무 상태
financial projections - 재무 예상
financial reporting - 재무 보고
financial strength - 재무 안정성
forecast - 예측
formal retention study - 정식 유지 연구
formulating - 수립
framework - 프레임워크
frc - 재무 및 위험위원회
full review and approval procedures - 전체 검토 및 승인 절차
fully-funded features - 완전 자금 조달 기능
funds withheld - 보류 자금
general counsel - 법률 고문
general principles - 일반 원칙
general risk climate - 일반 위험 환경
generation - 생성
global pandemic - 세계적 대유행
governance - 거버넌스
governance processes - 거버넌스 프로세스
group actuarial - 그룹 계리팀
group bod - 그룹 이사회
group brc - 그룹 사업 리스크 위원회
group business - 그룹 사업
group chief actuary - 그룹 최고 계리사
group compliance - 그룹 컴플라이언스
group corporate policy governance standard - 그룹 기업 정책 거버넌스 표준
group frc - 그룹 재무 및 위험 위원회
group life - 그룹 생명보험
group office - 그룹 사무소
group personal accident - 그룹 개인 사고
group risk management policy - 그룹 위험 관리 정책
group tax - 그룹 세무
group-wide enterprise risk management - 그룹 전체 기업 위험 관리
group’s risk appetite framework - 그룹의 위험 선호 프레임워크
growth - 성장
guaranteed rates - 보장된 비율
guideline - 지침
guidelines - 지침
head of claims - 청구 책임자
head of operations - 운영 책임자
headings - 제목
hong kong - 홍콩
ia - 보험 당국
identification - 식별 정보
implementation - 구현
implementation - 실행
in-force business - 유효한 사업
in-force reinsurance portfolio - 유효 재보험 포트폴리오
inability to recover claims - 청구 회수 불가능
income expectations - 수입 기대
increase in retention limit approval - 보유 한도 증가 승인
indemnity based triggers - 보상 기반 트리거
independent assessment - 독립적 평가
independent search - 독립적 검색
individual business - 개인 사업
individual excess of loss - 개별 초과 손실
industries - 산업
inflows - 유입
inquiries - 문의
insignificant risk transfer - 무의미한 위험 이전
insurance authority - 보험 당국
insurance business - 보험 업무
insurance risk - 보험 위험
insurance risk transfer - 보험 위험 이전
insured - 피보험자
insurer - 보험사
intermediaries - 중개자
internal accounting management system - 내부 회계 관리 시스템
internal approval - 내부 승인
internal audit - 내부 감사
internal case underwriting guidelines - 내부 사례 인수 지침
internal checking - 내부 검토
internal control - 내부 통제
internal reinsurance - 내부 재보험
internal underwriting guideline - 내부 인수 지침
interpretation - 해석
introduction - 소개
investment portfolio - 투자 포트폴리오
investment risk - 투자 위험
investors - 투자자
jurisdiction - 관할 지역
key factors - 주요 요소
key financial metrics - 주요 재무 지표
key internal controls - 핵심 내부 통제
key obligations - 주요 의무
key parties - 주요 당사자
key personnel - 주요 인력
key processes - 핵심 프로세스
key reinsurance arrangements - 주요 재보험 계약
key reinsurers - 주요 재보험사
key risks - 핵심 위험
key service providers - 주요 서비스 제공자
korea branches - 한국 지사
large claims - 대규모 청구
latest effective version - 최신 유효 버전
legal advice - 법률 자문
legal advisors - 법률 자문가
legal counsel - 법률 고문
legal opinion - 법적 의견
letter of credit - 신용장
level of capital - 자본 수준
licensed - 허가받은
limitation - 제한
limits - 한계
line of business - 업종
liquidity - 유동성
liquidity management and contingency - 유동성 관리 및 비상 계획
liquidity management risk standard - 유동성 관리 위험 표준
liquidity position - 유동성 상태
liquidity risks - 유동성 위험
liquidity sources - 유동성 출처
local approval process - 현지 승인 과정
local laws - 지방 법률
local legal team - 현지 법률 팀
local regulation - 지역 규제
local regulatory - 지역 규제
local regulatory requirements - 지역 규제 요구 사항
local reinsurance checking process - 현지 재보험 검토 절차
local reinsurance guideline - 현지 재보험 지침
local reinsurance providers - 현지 재보험 제공자
local sign-off - 현지 승인
location split - 위치 분할
long-term business - 장기 사업
long-term focused - 장기 중심
long-term trend risk - 장기 추세 위험
main body - 주요 내용
main risk - 주요 위험
management - 관리
management action - 관리 조치
management arrangements - 관리 계약
managing reinsurance arrangements - 재보험 계약 관리
managing role - 관리 역할
mandatory - 의무적인
mandatory and minimum requirements - 필수 및 최소 요구 사항
market - 시장
market participants - 시장 참여자
market practice - 시장 관행
market value - 시장 가치
material aggregation of risks - 주요 위험 집계
material arrangements - 중요 계약
material breach - 중대한 위반
material change - 중대 변화
material extent - 실질적 범위
material liquidity risks - 주요 유동성 위험
minimum requirements - 최소 요구 사항
mitigation - 완화
mitigation process/plan - 완화 과정/계획
mitigation processes - 완화 과정
modelling - 모델링
monitoring - 모니터링
monitoring report - 모니터링 보고서
name - 이름
name of the reinsurers - 재보험사의 이름
natural disasters - 자연재해
necessary approvals - 필요한 승인
needs - 요구
negative impacts - 부정적 영향
net amount at risk - 위험 순액
new applications - 새로운 신청
new business underwriting - 신규 사업 인수
new product/risk types - 새로운 제품/위험 유형
new risks - 새로운 위험
non-compliance - 비준수
non-guaranteed rates - 비보장 비율
number of policies - 정책 수
objectives - 목표
off shore reinsurance - 해외 재보험
offshore reinsurance providers - 해외 재보험 제공자
operational failures - 운영 실패
operational level - 운영 수준
operational matters - 운영 문제
operational risk - 운영 위험
operations delegation of authority standard - 운영 권한 위임 표준
original copy - 원본
other risk concentrations - 기타 위험 집중
outflows - 유출
outsourcing agreements - 아웃소싱 계약
outward - 외부로
oversight - 감독
pandemic exposure analysis - 팬데믹 노출 분석
parties - 당사자
past experience - 과거 경험
payments - 지불
peak accumulation analysis - 최대 축적 분석
peer reviews - 동료 평가
performance - 성과
periodic review - 정기적 검토
placement percentage - 배치 비율
placement process - 배치 과정
plan period - 계획 기간
plural - 복수
policy - 정책
policy administration systems - 정책 관리 시스템
policy exemptions - 정책 면제
policy owner - 정책 소유자
political conditions - 정치 조건
potential arrangements - 잠재적 계약
practices - 관행
primary insurance losses - 1차 보험 손실
primary policy contact person - 주요 정책 연락처
primary regulator - 주 규제 기관
principles - 원칙
priority - 우선순위
procedures - 절차
process - 절차
processes and controls - 절차 및 통제
product development - 제품 개발
product development stage - 제품 개발 단계
professional responsibilities - 전문적 책임
profit - 이익
profitable business - 수익성 있는 사업
proposed change - 제안된 변경
proposed spe structure - 제안된 spe 구조
prospective reinsurers - 예상 재보험사
protection - 보호
protection needs - 보호 필요성
purpose - 목적
quota share arrangements - 할당분 셰어 계약
quote - 견적
ramifications - 파급 효과
rationale - 근거
re-negotiating - 재협상
re-tendering - 재입찰
recapture - 회수
recapture fee - 회수 수수료
recapture rights - 회수권
recourse - 재산 반환 청구권
recovery of claims - 청구 회수
registered - 등록된
regular review - 정기 검토
regulation - 규제
regulatory approval - 규제 승인
regulatory capital - 규제 자본
regulatory capital requirements - 규제 자본 요구 사항
regulatory requirements - 규제 요구 사항
reinsurance - 재보험
reinsurance administration - 재보험 관리
reinsurance administration processes - 재보험 관리 프로세스
reinsurance approval process - 재보험 승인 과정
reinsurance arrangement - 재보험 계약
reinsurance arrangement terms - 재보험 계약 조건
reinsurance brokers - 재보험 중개인
reinsurance cash flows - 재보험 현금 흐름
reinsurance counterparty - 재보험 상대방
reinsurance credit risk standard - 재보험 신용 위험 표준
reinsurance deposits - 재보험 예금
reinsurance documentation approval - 재보험 문서 승인
reinsurance documentation standard - 재보험 문서화 표준
reinsurance documents - 재보험 문서
reinsurance governance - 재보험 거버넌스
reinsurance implementation process - 재보험 구현 과정
reinsurance knowledge - 재보험 지식
reinsurance management - 재보험 관리
reinsurance management policy - 재보험 관리 정책
reinsurance needs - 재보험 필요성
reinsurance offers - 재보험 제안
reinsurance operational risk assessment - 재보험 운영 위험 평가
reinsurance placement process - 재보험 배치 절차
reinsurance pricing - 재보험 가격
reinsurance pricing approval - 재보험 가격 승인
reinsurance pricing standard - 재보험 가격 책정 표준
reinsurance process - 재보험 절차
reinsurance rates - 재보험 요율
reinsurance recoverable - 재보험 회수 가능 금액
reinsurance recoveries - 재보험 회수
reinsurance recovery collection - 재보험 회수 수집
reinsurance recovery collection and settlement process - 재보험 회수 및 결제 과정
reinsurance reporting - 재보험 보고
reinsurance reporting and implementation - 재보험 보고 및 구현
reinsurance retention limits - 재보험 유지 한도
reinsurance standard - 재보험 표준
reinsurance tender document - 재보험 입찰 문서
reinsurance terms - 재보험 조건
reinsurance trust account - 재보험 신탁 계좌
reinsurance underwriting audits - 재보험 인수 감사
reinsured - 재보험자
reinsurer - 재보험사
reinsurer sourcing process - 재보험사 선정 과정
reinsurer - 재보험사
relevant parties - 관련 당사자
relevant policies - 관련 정책
relevant risks - 관련 위험
relevant stakeholders - 관련 이해관계자
remittable capital generation - 송금 가능 자본 생성
report - 보고서
reputation - 평판
request for proposal - 제안 요청
required capital charges - 필요 자본 요구
requirement - 요구 사항
residual risk - 잔여 위험
responsibility - 책임
responsible executive - 책임 임원
responsible party - 책임 당사자
retained net amount at risk - 보유 순 위험 금액
retained sum assured - 보유 확정 금액
retention levels - 보유 수준
retention limit - 보유 한도
retention management - 유지 관리
review - 검토
reviewing process - 검토 과정
risk aggregation on one life - 한 생명에 대한 위험 집계
risk and control assessment process - 위험 및 통제 평가 과정
risk appetite - 위험 선호도
risk appetite statement - 위험 선호 선언문
risk assessment - 위험 평가
risk capacity - 위험 수용 능력
risk committee - 위험 위원회
risk concentration - 위험 집중
risk exposure - 위험 노출
risk functions - 위험 기능
risk limits - 위험 한계
risk management - 위험 관리
risk management activities - 위험 관리 활동
risk management framework - 위험 관리 프레임워크
risk management needs - 위험 관리 요구
risk management strategies - 위험 관리 전략
risk metrics - 위험 측정지표
risk modelling - 위험 모델링
risk policies - 위험 정책
risk premium - 위험 프리미엄
risk principles - 위험 원칙
risk profile - 위험 프로필
risk strategy - 위험 전략
risk tolerance - 위험 허용 수준
risk tolerance levels - 위험 허용 수준
risk tolerances - 위험 허용 수준
risk transfer requirements - 위험 이전 요구 사항
risk-adjusted return on capital - 자본 대비 위험 조정 수익률
risk-based audit approach - 위험 기반 감사 접근
risks underwritten - 인수된 위험
rmp - 재보험 관리 정책
rmp monitoring - rmp 모니터링
robustness - 견고함
roles - 역할
roles and responsibilities - 역할과 책임
rolling quarterly basis - 분기별 롤링 기준
rora - 재보험 운영 위험 평가
rules - 규칙
rules of interpretation - 해석 규칙
safeguards - 보호 조치
sales growth - 판매 성장
sanction lists - 제재 목록
schedules - 일정
scope - 범위
screening process - 선별 과정
secondary liquidity sources - 2차 유동성 출처
security clause - 보안 조항
security ratings - 신용 등급
selection - 선택
selection criteria - 선택 기준
senior management - 고위 경영진
services - 서비스
setting - 설정
settlement - 결제
share buy-back - 주식 환매
shock level - 충격 수준
significant losses - 중대 손실
singular - 단수
sites/buildings - 사이트/건물
social conditions - 사회 조건
spe - 특수 목적 기구
spe structure - 특수 목적 기구 구조
special circumstances - 특별한 상황
specific risks - 특정 위험
sponsor - 스폰서
stability - 안정성
stakeholders - 이해관계자
standard exemptions - 표준 면제
standard process - 표준 절차
standards - 표준
state/province - 주/도
statutory earnings - 법정 수익
statutory requirements - 법정 요구 사항
structural lar - 구조적 유동성 적정성 비율
structural risk - 구조적 위험
structuring - 구조화
subsidiary legal entity - 자회사 법적 실체
suggested amendment - 제안된 수정
suitability - 적합성
sum assured - 확정 금액
supervision - 감독
supervisory framework - 감독 프레임워크
surplus basis - 초과 기준
surplus capital position - 잉여 자본 상태
surplus level - 잉여 수준
surplus treaty - 초과 계약
sustainability - 지속 가능성
sustainable - 지속 가능한
technicality - 기술적 사항
tender process - 입찰 과정
tendering process - 입찰 과정
terminating - 종료
termination - 종료
terms - 조건
terms and conditions - 조건
territory - 영토
terrorism peril - 테러 위험
third party assessments - 제3자 평가
timely manner - 적시에
tolerance - 허용 범위
tolerance levels - 허용 수준
total permanent disability - 전체 영구 장애
track record - 실적
traditional products - 전통적 제품
transactional exemptions - 거래 면제
transfer pricing guidelines - 이전 가격 가이드라인
treaty - 협약
types of information - 정보 유형
types of reinsurance arrangements - 재보험 계약 유형
uncertainties - 불확실성
uncertainty in pricing - 가격 불확실성
underlying subject matter - 기초 주제
underwriters - 인수자
underwriting - 인수
underwriting assistance - 인수 지원
underwriting authority - 인수 권한
underwriting authority limits - 인수 권한 한도
underwriting automatic acceptance - 인수 자동 승인
underwriting department - 인수부서
underwriting management - 인수 관리
underwriting manuals - 인수 매뉴얼
underwriting quality assurance framework - 인수 품질 보증 프레임워크
underwriting staff - 인수 직원
underwriting standards - 인수 기준
underwriting strategies - 인수 전략
up-to-date register - 최신 등록부
valuation systems - 평가 시스템
value - 가치
volatility - 변동성
war - 전쟁
within policy requirements - 정책 내 요구 사항
words - 단어
written agreement - 서면 합의
written line - 서면 한도
written quotes - 서면 견적